111111111111111111111111111111
1i                     a  
11111111111111111111111111111111111111111111111111111111111111111111   1                   c
1                       c 1111                                    1    1
1                                                                 1   11
1                        a   111                                  1    1
1                                 2221                            111  1
1                                                                     11
1         cc   m                      222                              1
1                                                                      1
1i    a 22222   m        a a a                  c                     11
111111111    111112222211             11111111122222222                1                             
                                       222                      11   111
        222                    222222222 

   11    22             11111                              2
a 11     2                                            2   o 2 
11     2         2   111                              2222222
      2          1      
     2           1   m  2222222222222222222 11
   2             1111111                      1
    2                                           1
     2                 m        m   m   c    m    c 
222222222222ww22222222222222222222222222222222222222222