333441111111111111111111111111111111111111111111111111111111111111111111111111111111                                            
i  a bp  a  k m  bbbb bbbbba    pppppppp a                 a            m     a   o1 
333111111 11111111111111111111111111111111   111111111111111111111111111111111111 11 
1     m m m m m m m m  a a a c c c a a a 11111                                  1  1 
1    1111111111111111111111111111111111111  c2                                1 1a11 
1111            K            k2             22    111111111111111111111       1    1 
1               1   mmm      1                    1cam m m                    1   c1 
1a    22222222222222222222222222222222222222222222222222222222222222222 2     11   1 
122    2                                                            a   2     1    1 
1    222            m           11       m      1111                   22c    1  111c
1      2a       1111111      11       11111111111111   111            2 2  c  1c   11
12222  2  a     1d        11     1    1       111111               22   2     1      
1     a2    a 111                1    1   1ccc111111      1111          2   c 1      
1   2222      a 1                1        1ccc111111                    2    c1111  1
1      2   m    1                11  111111111111111          1111    222     1c    1
122    2111111                   1c 111111111111111       m   m  m      2    c1     1
1      2                         1222222222222222222    22222222222222222    c1     1
1   2222       111          c                  cc                   a        11 11111
1      2          111                                   22222222222222222   111    c1
122    2             1111111   222222222222222     22222                      1     1
1    a 2                                                     c   c   c        1 11111
1   2222                                                                      1    c1
1      2 am a m  a  1      m  m    m  1                                       1 11111
1  2222222222222222222222222222222222222222222222222222222222222222222222222221    c1
1       aaaaaaaa                        m  m    m           m                     111
222222222222222222222222222222222222222222222222222222222222222222222222222 22     11
                                                                          242       