141411414 1 2 3 4 11111111111111111111111111111111111111111111111111111111111111111111111111111111111111111111111                                       
i aaa s as a a a a a a a a a a a a  mmmmmmmmmmmmmmmmmmmmmmmmmmmmmmmmmmmmmmmmmmmm                cccccccc c b    4
11414141414111111111111111111111111111111111111111111111111111111111111111111111111111111111111 11111111111111111
1 bbbbbbbb                                   KkKkKkKkKkKkKkKk                                                   4       
111111111111111                    111111111111111111111111111111111111111111111111111111111111111111111111111111 
1mmmmmmmmmmmmmmmm                                                    bcbcbcbcbcbcb     mmmmmmmmm         aaaa   4
11111111111111111111111111111111111                          1111111111111111111111111111111111111111111111111111 
1
11111111                 111111                    1111111111111            1111111111111111111111111111111111111               
1
11111111111111111111111111111111111111111111111111111111111111111111111111111111111111111111111111111111111111111
1
11111111111111111111111111111111111111111111111111111111111111111111111111111111111111111111111111111111111111111      
1
11111111111111111111111111111111111111111111111111111111111111111111111111111111111111111111111111111111111111111
1
11111111111111111111111111111111111111111111111111111111111111111111111111111111111111111111111111111111111111111
1 
11111111111111111111111111111111111111111111111111111111111111111111111111111111111111111111111111111111111111111
1
11 11111111111111111111111111111111111111111111111111111111111111111111111111111111111111111111111111111111111111
1   aaaaaaaaaaaaaaaaaaaaaaaaaaaaaaaaaaaaaa ccccccccccccccccccccc mmmmmmmmmmmmmmmmmmmmmmmmmmm                    3
1111111111111111111111111111111111111111111111111111111111111111111111111111111111111111111111111111111111111 111
1   mmmmmmmmmmmmmmmmmmmmmmmmmmmmmmmmmmmmmmmmmmmmmmmmmmmm   aaaaaaa                                              4
11 11111111111111111111111111111111111111111111111111111111111111111111111111111111111111111111111111111111111111
1aaaa   ccccc pppp  mmmmmmmaaaaaaaa a a k K k                             cccccc ppppp aaaaaaaaaaaaaaaaaa       o
11111111111111111111111111111111111111111111111111111111111111111111111111111111111111111111111111111111111111111 